WWWWWWWWWWW
W  R    R W
W  R    R W
W  R    R W
WR RRRRRR W
W R     R W
WWWWWWWWWWW

P,2,6,0,-1,0,3
L,2,1,0,-1,0
L,2,2,0,1,0
G,1,5,1,0,0
G,3,5,-1,0,0
G,1,6,1,0,0
G,3,6,-1,0,0
G,1,7,1,0,0
G,3,7,-1,0,0
L,5,7,0,1,0
L,1,9,1,0,0
G,4,2,1,0,0